0000000000000
1111111111111
1000000000001
1111103301111
0000103301000
1111103301111
1000003300001
1111103301111
0000103301000
0011111001111
0010000000001
0010000000001
1111111111111
