1100000000
1111110000
1111110000
0000110000
0000110000
0000110000
0000110000
0000110000
0000221111
0000221111
