1111100000
0000100000
0000100000
0001100000
0001100000
0001000011
0001000011
0001100011
0001100001
0002111131