000000000000
001111111000
001000001000
001111001000
000001001000
000001011000
011111010000
010000011000
011120001000
000010111000
000010100000
000020111112
