000011111110000
000110000011000
000100000001000
111100000001000
000000000001111
111100000001000
000100000001000
000110000011000
000011111110000