0000010001
0000010001
0000010001
0000010001
0000111011
1111111011
0000000001
0000011111
0000010000
0000010000
