000111111111000
000100000001000
000100000001000
111100000001000
000000000001111
111100000001000
000100000001000
000100000001000
000111111111000