222000000000
222000000000
010000111100
111111111112
111111111112
111000111100
111000000000
111000000000
111000000000
111111111222
221111111222
221111111222
