00001000000
01111111110
01000000010
01011110010
21011110011
21011100010
22000010010
00000010010
01111111110
02000010000
