1111100000
0000100000
0000100000
0001100000
0001100000
0001000000
0001000002
0001100002
0001100002
0001111111