100000000000000
100000000000000
100010101010000
000000000000000
100010000010000
000000000000000
101010000010000
000000000000000
000000000010000
000000000000000
000010101010000
000000000000000
000010000000000
000000000000000
000010101010111
