0100000000
0100000000
0100000000
0100000000
0110000000
0011000000
0001100000
0000100000
0000100000
0000111111
