0000000000
0330000000
0333000000
0033300000
0003330000
0003333000
0000333000
0000333111
0000000111
0000000111
