220000000000
110000111011
111111111112
110000111011
110000000000
110000000000
111111111222
221111111222
221111111222
000000000000
000000000000
000000000000
