1111111000000
1100001000000
1100001000000
1100001000000
1100001000000
1100000000001
1100000000001
1100000000001
1100000000001
1100000000001
1000000000001
1111111111111
1111111111111
