00000000000110110
01131010100001000
03001030100101011
01003010100100000
03301310100100111
00100000100001000
01111111111111110
00100000100000100
01101110101110110
00101000101000100
01101310101101110
01000310103301010
01101310101111010
01111110101100010
00000000100000000
