00000000000000
00011111000000
00110001000000
01100001000000
03000011000000
03000010000000
13331110000000
03000001111000
01011111001000
01010000001000
01030000011000
01333111110000
00010000000000
