000000010000000
000000010000000
000000010000000
000000010000000
000011111110000
000010000010000
000110000011000
000110000011000
000110000011000
000010000010000
000011111110000
000000111000000
000000000000000
000000010000000
000000010000000
