00000000000000
00023333111100
00000000111100
00111111111111
00100000111100
00100000111112
00100000000001
11100000000001
00100000000001
00111111111101
00111111111101
00000000000001
00000000000000
00000000000000
