1111100001
1100100011
1101110001
1101111101
1101110011
1100100001
1100000001
1111111111
1100000000
1111111111
