000000000000000000000
033311111111111111110
032311111111111111110
033300000000000000110
011023311111101111010
011033311111111111010
011033300000000000010
011011101111101111010
011011101111101111010
011011101111111111010
011011101111101111010
011011100000001111010
011011111111001111010
011011111111101111010
011011000000000000110
011011111111111111110
111011111111111111110
111000000000000000000
