11111111111111
10000000000001
11110111101111
00010100101000
11110100101111
10000100100001
11110100101111
00010100101000
11110100101111
10000100100001
11110100101111
00010100101000
11111100111111
